[level]
map = wwwwwwwwwwwwwwwwwwwwwwwww
      w.......................w
      w.......................w
      w.....wwwwwwwwwww.......w
      w.......................w
      w.......wwwwwww.........w
      w.......................w
      w........wwwww..........w
      w.......................w
      w.........www...........w
      w.......................w
      w..........w............w
      w.......................w
      w.......................w
      wwwwwwwwwwwwwwwwwwwwwwwww